xxxxxxxxxxxxxxxxxxxx
x s  xx  c         x
xP  hxxxxxxx f   f x
x    xxxxxxx    xxxx
xx  xx cf       F  x
x     xxx  x  xx  fx
x f        xf xx   x
x   xx f   x  xx l x
x   xx    fx fxx   x
xxxxxxxxxxxxxxxxxxxx