xxxxxxxxxxxxxxxxxxxx
x s  xx  c         x
xP  qxxxxxxx m   m x
x    xxxxxxx    xxxx
xx  xx cm       m  x
x     xxx  x  xx  mx
x m        xm xx   x
x   xx m   x  xx l x
x   xx    mx mxx   x
xxxxxxxxxxxxxxxxxxxx